11111111
1ECCP0E1
10000001
10000001
11111111
11111111